[
    {
    "id": "room_one",
    "map1": [
                [1, 1, 1, 1, 1, 1, 1, 1],
                [1, 0, 1, 0, 0, 0, 0, 1],
                [1, 0, 1, 0, 0, 0, 0, 1],
                [1, 0, 1, 0, 0, 0, 0, 2],
                [1, 0, 1, 0, 0, 0, 0, 1],
                [1, 0, 1, 1, 1, 1, 0, 1],
                [1, 0, 0, 0, 0, 0, 0, 1],
                [1, 1, 1, 1, 1, 1, 1, 1]
            ]
    },
    {
        "id": "room_two",
        "map2": [
                [1, 1, 1, 1, 1, 1, 1, 1],
                [1, 0, 0, 0, 0, 0, 0, 1],
                [1, 0, 1, 0, 1, 1, 0, 1],
                [3, 0, 1, 0, 0, 1, 0, 1],
                [1, 0, 1, 0, 0, 1, 0, 1],
                [1, 0, 1, 1, 1, 1, 0, 1],
                [1, 0, 0, 0, 0, 0, 0, 1],
                [1, 1, 1, 1, 1, 1, 1, 1]
            ]
    }
]